         #####   
      ####   #   
   ####    # #   
####  $ # $  ##  
#   .#.$.$.$. #  
# # $.$.$.$.# #  
#  $.$.$.#.$.$## 
## .$.#.$.$.$  # 
 # #.$.$$$.$.# # 
 #  $.$.$.#.$. ##
 ##$.$.#.$.$.$  #
  # #.$.$.$.$ # #
  # .$.$.$.#.   #
  ##  $ # $  ####
   #$#  @ ####   
   #   ####      
   #####         
Author: David Holland and GRIGoRusha
Comment:
added 2 boxes
Comment-End:
