     #####
  ####   #
###@ *   #
#  * * .##
#  $**  #
###  ####
  #  #
  ####
Author: Dries De Clercq and GRIGoRusha
Title: Come back
