###################
#        # .   .  #
# #$##$# # #$##$#.#
#.#.##. $  $ ##  $#
# # $ $# # #.$ $#.#
#. .##.  #   ##.  #
# # ## #####$##$# #
# $.  .$ # . $ .  #
# $.  .$@# . $ .  #
# # ## #####$##$# #
#. .##.  #   ##.  #
# # $ $# # #.$ $#.#
#.#.##. $  $ ##  $#
# #$##$# # #$##$#.#
#        # .   .  #
###################
Author: William Fraser and GRIGoRusha
Comment:
gr: Added 1 wall, moved some targets
gr: Added 1 wall, added 6 boxes, moved some targets
Comment-End:

