  ####   
  #  ### 
  # $  # 
### *  # 
#  * *###
# # *   #
# #*@*# #
#   * # #
###*.*  #
 #  * ###
 #    #  
 ###  #  
   ####  
Author: GRIGoRusha and Gyjgw
Comment:
added 4 walls
Comment-End:
