     #####
######   ##
#         #
# # ###$# ##
# $$##     #
##..*..#   #
 #@#*### # #
 #  * $    #
 ##   ######
  #####
Author: GRIGoRusha
Title: The Turn
Comment:
added 1 box
Comment-End:
