 ########
 #  #   #
 #    # #
##$*.*  #
#  #  ###
#  * *  #
# #* *  #
#  @#####
#####
Author: GRIGoRusha
Title: Red Canyon
	