####  #####
#  ####   #
#  $@$    #
# $#$### ##
## ..... #
##$#.## ##
#  $    #
#   ##  #
#########
Author: GRIGoRusha
Comment:
added 2 walls
Comment-End:
