 ####
 #  #######
 # .* #   #
 #  *.$   #
## #*.$#$##
#   *.@# #
#   # $  #
#####  ###
    ####
Author: GRIGoRusha
Title: Razvorot
Comment:
added 1 wall
Comment-End:
