  ####
  # @####
  #$**. #
### .#. #
#    . ##
# $$#$ ##
##      #
 #  #   #
 ########
Author: GRIGoRusha
Comment:
gr: added 2 walls, remove 1 boxe
Comment-End:
