  ####
###  ##
#  *  ##
#  *#  #
## * * ##
 # @*   #
 # * *  #
 #####  #
     ####
Author: GRIGoRusha
Title: Koshkin Dom
Comment:
date: 06.07.06
Comment-End:
