 ####
 # @#
## $###
#  *  #
#  *# ##
# **   #
##.#   #
 #   ###
 #####
Author: GRIGoRusha
Title: Collapse comet
Comment:
date: 06.11.05
gr: stoned 1 boxe
Comment-End:
