##########
#   ## @ #
#    $ $ #
## # ##$##
 # ..* $ #
 # # .   #
 # # *# ##
 # ***. #
 ###   ##
   #####
Author: Nakamiya and GRIGoRusha
Title: The First Hunter
Comment:
remove 1 wall, added 2 boxes

second remodel from nakamiya new 02
Comment-End:
