   ####
 ###  #
##   $#
#  .*@###
#  ***  #
### *   #
  # # ###
  #   #
  #####
Author: GRIGoRusha
Title: Light Target
Comment:
unfinished level from GrigrSpecial 21
Comment-End:
