  ####   
 ##  #   
 #  .####
##.$. . #
# .$.$# #
#@ $ $  #
#### $###
   #  #  
   ####  
Author: GRIGoRusha
Title: Light Ladder
Comment:
other position variant for GrigrSpecial 21
Comment-End:
