  #####
###   ###
# ...$. #
# #$.$# #
# .$.@# #
##$# $# ##
 #   $   #
 #  ##   #
 #########
Author: GRIGoRusha
Title: Brave Warrior
Comment:
added 1 wall
Comment-End:
