  ######
  #    ###
 ##$ #   #
 #@$   $ #
## #   # #
# ***# $ #
# .*.  ###
###..###
  ####
Author: Kenyam and GRIGoRusha
Title: New Dance