  ######
### *  ###
#  .*..  #
# # *  # #
# @#*#$$$##
##        #
 ###### # #
      #   #
      #####
Author: Kenyam and GRIGoRusha
Title: Direct Angle