 #########
##  #@   #
#   * *  #
#  $*.*$ #
### .## ##
  #  $  #
  # *.* #
  #  #  #
  #######
Author: Aymeric du Peloux and GRIGoRusha
Title: Piramid