      ####
    ###  #
    #    #
  ### #  #
  #  $* ##
 ## $@.$##
##  $#.$ #
#... #*# #
# ###    #
#     ####
#######
Author: MIC and GRIGoRusha
Title: Sewen Friends
Comment:
date: 21.11.07
Comment-End:
