  #####   #####
  #   #####   #
  #         $ #
  ## ####### ##
   #@##  ###  #
#### ##$    $ #
#  # #.*.###  #
#    #... .####
# $# #*.# *#
## # #     #   
 # # #### $#  
 # $       #  
## ####### #  
# $        #  
#   ########  
#####         
Author: Mic and GRIGoRusha
Title: Feb 2005 Monthly level remodel
Comment:
added 2 walls and 1 box
Comment-End:
