    ####
 ####  ####
 #   *    #
 #  .*#.. #
 # #   # ##
##*# $ $$##
#  ##*#   #
#    * **@#
#  ##*#   #
##*# $ $$##
 # #   # ##
 #  .*#.. #
 #   *    #
 ####  ####
    ####
Author: Ljy and GRIGoRusha
Comment:
gr:added 2 walls and redesign
Comment-End:
 
