#######  #### ####
#  #  #  #  ###  #
# $$  #### $ $   #
#  #$ #  # $  $  #
## #@    #   ## ##
 # #$ #$ #   $  #
 # #  # ## $ #  #
 # #### ####$####
 #  $ # #    # 
 # # .*...$# # 
## # .  $. # ###
#.* ##   ##  * #
#..* #####  $  #
#...$     ...* #
# ..############
######        
Author: David Holland and GRIGoRusha
Comment:
added 8 walls
moved 2 target
Comment-End:
