 ###########
 #         ####
## #######    #####
# $#  #  ####     ##
#    $$  #  # $$$  #
#  #  #.$#.$  $  # #
#####  #.#.#  #$   #
    # *....## $   ##
    # #...*@# $ ###
   ##$#...* # ###
   #  #######  #
   #         $ #
   ##########  #
            ####
Title: Maelstrom Collection
Author: David Holland, York Shen and GRIGoRusha
