       #####
  ######   #
  #  $ $$ $##
  # ## # $  #
  #     $   #
  # ###$# ###
 ##.#   # #
 #..* #   #
 #..* # ###
 #..* # ###
##$#### $ #
#      .. #
# @ #######
#####
Author: Mario Bonenfant and GRIGoRusha
Comment:
moved 1 boxe
Comment-End:
