######    #######
#  ..#    #  #  #
#  ..###### $#  #
## #.  $ ##  $  #
 # .$$$   # ##$##
 #.#..#$ $  #  #
 #.#.## ### $  #
 #.#   $ ## #  #
 #.### @ ## ##$#
 #.   ####     #
 #.$$    $  $# #
 #. ########   #
 ####      #####
Author: David  W. Skinner and GRIGoRusha
Comment:
added 2 boxes and 4 walls
Comment-End:
