    ####
    #  ######
    #  $ $  ###    ####
    #   $     #   ##  #
#####*#*##$$  #  ## $ #
#     $ $   $ # ##    #
#  #$    $ $##### $$ ##
##$# ####$......#   ##
#  $   # $..**.## ###
#  $#  # $$ #.##.   #
##     #    #.#+* # #
 #     ######.##..$ #
 ####### # $..##.####
         # # *..*.#
         #   .#.  #
         ######$# #
              #   #
              #####
Author: David W. Skinner and GRIGoRusha
Comment:
added 3 boxes
added 1 wall
Comment-End:
