   #####
  ## @ ######
  #  $   #  #
  #$ # $ $$ #
###  ###$#  #
#..*.#   # ##
#.*..# #$#  ###
##.*.... ##   #
# .##.##$#### ##
#   #. #  $  $ #
#   $$$# #  $  #
#####. # ##   ##
    #*    #####
   ##.$ # #
   # $    #
   #   ####
   ##### 
Author: David W. Skinner and GRIGoRusha
Comment:
added 6 boxes and some changes
Comment-End:
