 #####
##   # ####
#    ###  #
#  # @#   #
##$####   ######
# ... .  ##    ##
# ... .#    ##  #
####$# #####  # ##
   # #       $#  #
   # # $ $ $$  # #
   #  #####  $ # #
   ##      #   # #
    ######  ###  #
         ##     ##
          #######
Author: David W. Skinner and GRIGoRusha
Comment:
added 2 boxes
Comment-End:
