#############
#.*.*.*.*.*.#
#* $ $$$ $ *#
#.$.$.$.$.$.#
#* $.$+$.$ *#
#.$.$ $.$.$.#
#* $.$*$.$ *#
#.$.$.$ $.$.#
#* $.$*$.$ *#
#.$.$.$.$.$.#
#* $ $ $ $ *#
#.*.*.*.*.*.#
#############
Author: Monry and GRIGoRusha
Comment:
gr:Added 3 boxes, moved some targets
Comment-End:
