####  #####
#  ####   #
#         #
# @.# #$$##
###.# #  #
 # .*.# ##
 # $ $   #
 #####   #
     #####
Author: Mic and GRIGoRusha
Title: June 2003 Monthly level remodel
