#####       
#   ########
#        $ #
##.#####   #
##.#   ## ##
# .   $## # 
# .## @##$# 
##.##  ## ##
 #.###   $ #
 #   $ $   #
 #####  ####
     ####   
Author: Mic and GRIGoRusha
Title: January 2002 Monthly level remodel
