    #########
    #   #   #
    # $     #
  #### ###  #
  #  # ### ##
###  # ## $ #
# $ $ $##.  #
#   #$ ..**.#
## ##@ #.*.*#
# $ $ ###...#
#   # $   ###
###   #####
  #####
Author: Mic and GRIGoRusha
Title: July 1998 Monthly level remodel
Comment:
added 2 walls
Comment-End:
