  ##### 
###   ##
#  $$  #
# $..$ #
#  **  #
##$..$##
 # ** # 
 # ..@# 
 ###### 
Author: Mic, Hir and GRIGoRusha
Comment:
added 1 wall
Comment-End:
