########## ####
#   ##   ###  ##
# $   $ $ $@$  #
##$### ## #.#  #
# *  # #  #.  ##
#.*..#   $$**$#
#  ..###  #.. #
### ##  # #.. #
# $$ # $  #.# #
#       #     #
######  #######
     ####
Author: Marcus Palstra, GRIGoRusha and York Shen
Comment:
addeded 2 boxes
Comment-End:
