              ####
  #############  #
  #   $  $ $ $ $ #
  #  #$#       # #
  # $  @  #### $ #
  #  ##$# #### # #
  # $# $  #  # $ #
  #  # $ # $ # # #
  # ## ## $ .#.# #
  #$    #$ #.#.# #
### ### $   ...  #
#  ...###### ###$#
# #*#.        ...##
#  .#.##### ####* #
##  $     $  .....#
 #  ###############
 ####
Author: Marcus Palstra and GRIGoRusha
Comment:
added 2 boxes
Comment-End:
