      ######  ########### @  ####  ##    $ $# *...  $### #$ ... #...*    ##   #.#*# *.####$#####$ . . #..#     # #  $ #$# $    #$## ##$  # ##  $#$   # #   #  .*.#   #$## ##$   #...# #$   ####  $# #*# $  #$### $ #  .....   #  ## # $ $ $ $ $     ##   ####################Author: Marcus Palstra, GRIGoRusha and York ShenComment:added 7 boxesComment-End: