 ####         ####
 #  ###########  #
 #...            #
 #.#.####$#$###  #
 #.#.#  #        #
 #   # ##$## $ ###
 ##  # #... $ #  #
  # ## #.#.#     #
### ####.#*##$#  #
#  $##   # @  # ##
#  $ # $ # ####  #
## # #$#$#$ ##...#
 #          $ .#.#
 #$## # # ## $.#.#
 #  $ $ $   $  $ #
 #   #############
 #####
Author: Marcus Palstra and GRIGoRusha
Comment:
added 1 wall
Comment-End:
