 ####
 #  ###############
 #  $   $    $    #
 #  ##  $   # ### #
 #$ ####.####   # #
 #  ###.*.$   #$  #
 #$ ## .#.###   ###
 #  ## $$ ..# #$#
 #$ ##  #@#.*$  ###
 #   .#.# .. $ $$ #
 #$ #...#$##### # #
 # $##.##..   #.  #
##$     **# # ..* #
#   $ $  .. ###*  #
# $#######  # #  ##
#  #     #### ####
####
Author: Marcus Palstra and GRIGoRusa
Comment:
gr:added 5 boxes
Comment-End:
