  ############     
  #  #  ##   #     
  #    $@$   #     
 ## ###$### #####  
 #...## ###.....#  
 ##...# ##...##$###
  ##...  ..#** $  #
####$###$#...  #  #
#    ##  #### ##$ #
# $# ## ##  #     #
##      ########$ #
 # ###      $  $  #
 # #  ## #  #  $ ##
 # $ $   $ # $$ $ #
 #  $ $ #$##      #
 ###      #########
   ########        
Author: Marcus Palstra, GRIGoRusha and York Shen
Comment:
addeded 7 boxes
Comment-End:
