########     ####
#..##  #######  #
#..  $      $.. #
#..### $ #####. #
#  ##  #$#   #$##
# $## $#   @ #  #
#  ##    ##$##  #
# $#####.##  #  #
#  #..$...   ##$##
# $#..* .#### $  #
#  ##.#### $ $ $ #
#  ## ..##  $ $  #
## ## ...# $ $ $ #
#  ###*** $ $ $  #
#     ...# $ $ $ #
##########       #
         #########
Author: Marcus Palstra and GRIGoRusha
Comment:
added 5 boxes
Comment-End:
