   #####
 ###   #
##     #
# ****##
#     #
# +*$##
###  #
  #  #
  ####
Author: Aymeric du Peloux and GRIGoRusha
Comment:
added 1 wall
Comment-End:
