#####
#   ###
# + * #
## #  ###
# ***$  #
#       #
####  ###
   ####
Author: Aymeric du Peloux and GRIGoRusha
Comment: 
gr: added 2 walls
Comment-End: 
