  #####
### + ###
#  * *  #
# * * * #
## * * *#
 #* * * #
## * * *#
# * * * #
#   $   #
###    ##
  #  ###
  ####
Author: Francois Marques and GRIGoRusha
Title: Remodel Novembre2001ter2