#################
#       #       #
# * * * * * * * #
#  * * * * * *  #
# # * * * * * # #
# ## * * * * ## #
# ### * * * ### #
# # ## * * ## # #
# ##### + ##### #
#   #  * *  #   #
### # * * * # ###
  #  * * * *  #
  # * * * * * #
  ####  $ #####
     ##   ##
      #  ##
      ####
Author: Francois Marques and GRIGoRusha
Comment:
added 7 boxes
added 3 wall
Comment-End:
