  ###########
 #     #     #
 # * * * * * #
#   * * * *   #
# ## * * * ## #
# ### * * ### #
# #####+##### #
# ##  * *  ## #
# ## * * * ## #
#   * * * *   #
 # * * * * * #
  ###  $ ####
     #   #
     #  #
      ##
Author: Francois Marques, GRIGoRusha and York Shen
Comment:
gr: added 2 wall
date: 29.07.06
gr: added 2 wall
date: 30.07.06
gr+ys: added 1 wall
Comment-End:
