  #########
  #.*.#.*.#
  #*.*.*.*#
  #.*.*.*.#
  #*.*.*.*#
  #.*.*.*.#
  ###$.$###
    #   #
###### ######
#     $     #
# $ $ $ $ $ #
## $ $ $ $ ##
 #$ $ $ $ $#
 #   $@$   #
 #  #####  #
 ####   ####
Author: Unknown and GRIGoRusha
Title: Thinking Rabbit Original Sokoban level
Comment:
added 2 boxes
Comment-End:
                                              