        #####
    #####   ###
   ## $   #   #####
   # $ $    #   $ #
####  $   # $ $ $ #
#  # ####### ##   #
#        $ $$ #   #
#  ####### #  $  ##
##$#  #  .*.# # ##
 # $$  @$...#   #
 #  $ ####.##.###
 ##    ##..... #
  ##   ##..... #
   #############
Author: Yasuhiro Morita and GRIGoRusha
Title: Thinking Rabbit Perfect Sokoban level
Comment:
gr:added 1 boxe, 1 wall
Comment-End:
