           ####
   #########  #
   #        $ #
   #*#######  #
####@####### ####
#   *   #   *   #
#  * *  #  * *  #
# * * * # * * * #
#* *#* *#* *#* *#
# * * * # * * * #
#  * *  #  * *  #
#   *   ##  *  ##
#### ####### ###
  #  #  *  #   #
  # $.* *  # # #
  #  #  * *.   #
  ####  *  #####
     #######
Author: Thinking Rabbit, York Shen, GRIGoRusha, Gyijw
Comment:
ys: added 4 boxes
gr: added 1 box
gjw: stoned 2 boxes
Comment-End:
