     #####
  ####   ###
  #    #   ###
 ## # .$.#   #
 #  $.#.$.$# #
## #.$.$$$.  ##
#  .$$$+$.#.  #
# #$.$.#.$.$# #
#  .#.$.$$$.  #
##  .$$$.$.# ##
 # #$.$.#.$  #
 #   #.$. # ##
 ###   #    #
   ###   ####
     #####
Author: David W. Skinner, York Shen and GRIGoRusha
Comment:
ys:added 1 wall
gr:added 4 boxes
Comment-End:
