         ####
    ######  ####
   ##        $ ##
####  #### ###  ##
#   $ #..#.#  #  #
# # $ #.... $@ # #
# #   #..### $ # #
# # $#....  #  # #
# #  # $ #$  # # #
# #$ # ## $$ $ # #
# #  #..*    ##  #
# #$$## #  ##   ##
# #     ###   ###
#  ####$    ###
##      #####
 ########
Author: David W. Skinner and GRIGoRusha
Comment:
added 2 boxes
added 2 wall
Comment-End:
