    ####
   ##  ####
   # $   .########
   # $ # .   $ $ #
#### ### .#### # #
#  ....#$ #  # # #
# #..$ # .#$ # # #
#  ##  $$$@$ # # #
##   ### #   # # #
 ###   #  ## # # #
   ### # ...     #
     # #$*.*$#  ##
     # # ...$ ###
     # #$ #   #
     # $ ######
     #  $ #    
     ##   #
      #####
Author: David W. Skinner and GRIGoRusha
Comment:
added 1 boxes
added some walls
Comment-End:
