     ######
######    #
## $   $$ #
# $  ##   #
# $##  #$ #
# $ $$ #  #
# .....#$ #
##@#*#* $ #
 #.....#$ #
 #...**#  #
 #  $    ##
 ####  ###
    ####
Author: David W. Skinner and GRIGoRusha
Comment:
added 1 boxe
added 1 wall
Comment-End:
