      ######
      #    #
      # @  ###
####  #.$$   #
#  ####..#.#*#####
# $ $ ##.*.*     #
#    ....*.#$$   #
###### ##*## #####
     #  $    #
     #### ####
       #  #
       #  #####
     ### $    #
     #  $ $   #
     # #$# ####
     #     #
     #######
Author: David W. Skinner and GRIGoRusha
Comment:
added 5 boxes
Comment-End:
