  ####  ####
  #  ####  ####
###     $ $   #
#    # $  *.*.##
# $ ###### #.*.#
##   #    $ .. #
 # $$ $$@ #...##
 #   #  #######
 ####   #
    #####
Author: David W. Skinner and GRIGoRusha
Comment:
added 3 boxes
Comment-End: