 ######### 
 #    #  # 
 # ## $$ # 
 #   $   # 
## ####@## 
#   $ #$###
# $$#...$ #
##  ...#$ #
 #  #...  #
 #######  #
       ####
Author: Mic and GRIGoRusha
Title: Nine Works :)
Comment:
gr:added 3 boxes
Comment-End:
