     #######
######     #
#   ## ### #
#    .$#.  #
##$# *...$##
#  ##.##. # 
#     ### ##
##$##$$    #
 #@   ## $ #
 #######   #
       #####
Author: Mic and GRIGoRusha
Comment: 
gr: added 1 wall
Comment-end:
