 #####     ##### 
##   ##   ##   ##
#  $. ## ## .$* #
# $.$. ### * .$ #
# .$*$. $ . . . #
## .$.$ # $. * ##
 ## .$. # *$. ## 
  ##   ###   ##  
   #$### ###$#   
  ## $ ###   ##  
 ## *   # .$. ## 
## * . $# $. * ##
# *   * $ . * * #
# $. * ### * .  #
# @$* ## ## * $ #
##   ##   ##   ##
 #####     ##### 
Author: Mic and GRIGoRusha
Comment:
added 4 boxes
Comment-End:
