#####  ####
#   ####  #
# $     $ #
## #$$##  #
#     ## ##
#   ####..#
##$$$.....#
 # @####  #
 ####  ####
Author: Mic and GRIGoRusha
Comment:
added 1 boxe
Comment-End:
