      #### 
  #####  # 
  #...#  # 
  #.$.$ $# 
  ##...  # 
  ##.##@$# 
  # .##  # 
###$ ###$##
#         #
#  $ $ $  #
## $#######
 #  #      
 ####      
Author: Mic and GRIGoRusha
Comment: 
gr: added 2 walls
Comment-end:
