 ####### #######
##     # #     ##
# $$ $ ### $ $$ #
#   $ $ # $ $   #
# $ $.#.#.#.$ $ #
## $#...#...#$ ##
 #.  *.*+*.*  .#
 #$##...#...##$#
 # ### ### ### #
 #     ###     #
 ####$  $  $####
    #  ###  #
    #### ####
Author: Mic and GRIGoRusha & M. Letrab
Comment:
added 4 boxes
Comment-End:
