  ####    
  #  #####
  #$ #   #
### $    #
# $.###$##
# #.+.*. #
# #*.*.. #
#  .$ ## #
#  $#    #
### ##$ ##
 #   $  # 
 #  $#  # 
 # # #### 
 #   #    
 #####    
Author: Mic and GRIGoRusha
Comment:
gr:added 2 boxes and 1 wall
Comment-End:
