     #####   
   ###   #   
   #   $ #   
   # $ $#### 
   # # $   # 
#### ##  $ # 
#  $ ####  # 
#@ $  ..# ## 
###$### # ###
 #  #....*  #
 #  $ .*..  #
 #  #  ######
 #######     
Author: Mic, York Shen and GRIGoRusha
Comment: 
ys: added 2 boxes
gr: added 1 boxe, added 2 walls
Comment-end:
