 #############
##           #
# $********* #
# *   *  * * #
# *  *  *  * #
# * *$ *  ** #
# **  ** * * #
# *  *  *  * #
# * * **. ** #
# **  *  * * #
# *  *  *  * #
# *********+ #
#            #
##############
Author: Sven Egevad, York Shen and GRIGoRusha
Comment:
ys:added 2 boxes
gr:added 1 boxes
Comment-End:
