#####
#   #####
# # #   #
# $   $ #
## #.# ##
#  #.# # 
# $...$# 
## #.#@##
 # #.#  #
 #$ $ $ #
 #   #  #
 ########
Title: Twisty 1 short (remodeled)
Author: Martin P HOLLAND & Marek LETRAB & GRIGoRusha
Comment:
Taken 4 walls and 4 floors - Marek LETRAB
Some changes - GRIGoRusha
Comment-End:
