        #######
        #  #  #
        #     #
        #  #  #
    ######$# ##
 ####  #...   #
 #   $ ..*### #
## #$  #....# #
#  $  ##.*..$ #
# $#####*.#.###
#     $ .*# #
### #   #  $##
  # ######   #
  #   $    $@#
  # $ ### ####
  # # #    ##
  # $ $ #   #
  ####$ $ # #
     #  #   #
     ########
Author: Ziko, GRIGoRusha and York Shen
Title: October 2001 G4B Monthly level remodel
Comment:
added 2 boxes
Comment-End:
