      #########  
   ####.......###
   #  ..$ ##.*. #
 ### $##$###... #
 #    #   ##*#*##
## $#$# $ #..#. #
#    $ #$ #..*$ #
# #$$# #   ..#  #
# # $   ###.##$@#
# #   $    . #  #
# $ #$ ### * #$ #
# # $ $ $ #.$$  #
# $ $      .$  ##
##  ############ 
 ####            
Author: ZIKO and GRIGoRusha
Comment: 
gr:added 1 wall, moved 1 target
Comment-end:
