    #######    
######    ### 
#  # $$ $   # 
#        ## # 
#  ######## ###
## #      $$  #
 # #  $  #..$ #
 # ## $###.#  #
##$###.# ..####
#...#..# $$  # 
#.. $..$$@#$ # 
##     #     # 
 ############# 
Author: ZIKO and GRIGoRusha
Comment:
added 2 walls
Comment-End:
