         #####  
##########@  #  
#    #    $# #  
# ## # $$  $ #  
# #     # $# #  
# $$ ####  $ ###
###  #   $ $   #
###*$#  $ # $$ #
#... ### #### ##
#.....    #   # 
#.*####   # ### 
#.....##### ##  
#####.     $ #  
    ######   #  
         #####  
Author: ZIKO and GRIGoRusha
Title: March 2001 G4B Monthly level remodel
Comment:
added 1 boxe
Comment-End:
