 ####### 
 #     # 
##$ $$ ####### 
# $  # ###   #### 
#  # #   $$ $  ## 
## $$# #  $ $ $ # 
 #    .####  #$ # 
 ## ##.##.  $ $ # 
 # $....*.##$ # # 
 # $.####*##   @# 
 # $....*.###$ ## 
 #   ##......$ # 
 ######.##### ## 
      #       # 
      ######### 
Author: ZIKO and GRIGoRusha
Comment: 
gr: change 1 box to 1 wall
Comment-End: 
